111111111111111111111111111
111000000000C00000000000111
110P00001100000111111000011
100000011000001100011000001
10000011000000000011000C001
1000011C01100000011000CCC01
100011111111100011C0000C001
100C00000110000111111100001
100000000000000000000000001
100000001111000111100000001
1100000011000E0001100CC0011
111C00001100000001100000111
111111111111111111111111111
