1111111
1000001
10PC0E1
1000001
1111111