111111111111111111111111111
111111111111111111111111111
111000000000C00000000000111
110P00001100000111111000011
100000011000001100011000001
100000110000000000110000001
100001100110000001100000001
100011111111100011000000001
100000000110000111111100001
100000000000000000000000001
1000000011110001111000C0001
1100000011000E0001100000011
111000001100000001100000111
111111111111111111111111111
111111111111111111111111111
111111111111111111111111111
