111111111111111111111111111111
111111111111111111111111111111
1111000000000C0000000000011111
1110P0000110000011111100001111
110000001100000110001100000111
110000011000000000011000000111
110000110011000000110000000111
110001111111110001100000000111
110000000011000011111110000111
110000000000000000000000000111
11000000011110001111000C000111
11100000011000E000110000001111
111100000110000000110000011111
111111111111111111111111111111
111111111111111111111111111111
111111111111111111111111111111
111111111111111111111111111111