1111
1P11
1C11
1E11
1111
    
    
    
				
