111111111111111111111111
1P11
1C11
1EC1
1111