1111
1P11
1C11
1ECE
1111
    
    
    
    