11111111111111111111111111111111111111111111111111111111
11111111111111111111111111111111111111111111111111111111
11011111111111111111111111111111111111111111111111111111
11000000000000000000000000000000000000000000000001111111
11000000000000000000000000000000000000000000000001111111
11011111111111111111111111111111111111111111111111111111
11011111111111111111111111111111111111111111111111111111
11011111111111111111111111111111111111110000000000000001
11011111111111111111111111111111111111111111111111111111
1101111111111111111111111111100E0000CP001111111111111111
11011111111111111111111111111111111111111111111111111111
11011111111111111111111111111111111111111111111111111111
11011111111111111111111111111111111111111111111111111111
11011111111111111111111111111111111111111111111111111111
11111111111111111111111111111111111111111111111111111111
